#separator:tab
#html:false
What are compounds	Compounds contain two or more different elements chemically combined in a fixed proportion
How do compounds differ from their elements	Compounds usually have totally different properties to the elements that they come from
What is a mixture	In a mixture, there are different elements or compounds not chemically combined togther
How would you separate a mixture	To separte a mixture use physical techniques rather than chemical reactions
How would you separate a compound	To separate a coumpound back into its elements, a chemical reaction is needed
What is a molecule	A molecule has any element chemically joined
What is the periodic table	The periodic table lists all the chemical elements, with eight main groups each containing elements with similar chemical properties
What is the law of covservation of mass	No new atoms are ever created or destroyed in a chemical reaction, the total mass of reactants is equal to the total mass of products
What is filtration	Filtration is used to separate an insoluble solid from a liquid
What is crystallisation	Crystallisation is used to separate a soluble solid from a liquid
What is distillation	Distillation is used to separate a liquid from a solid if we want to keep the liquid
What is paper chromatography	Paper chromatography separates mixtures of substances dissolved in a solvent as they move up a piece of chromatography paper
Why are substances separated in chromatography	The different substances are separated because of their different solubilites in the sovlent used
What is fractional distillation	Fractional distillation is an effective way of separating miscible liquids, using a fractionating column.
Why is fractional distillation possible	The separation is possible because of the different boiling points of the liquids in the mixture
Why don't atoms have an overall charge	Atoms have no overall charge because the number of electrons is the same as the number of protons
How big is the radius of an atom in nanometres and metres	0.1nm or 1 x 10-10m
How big is the radius of the nucleas in metres	1 x 10-14m
What is the mass number of an atom	The number of neutrons and protons in the atom
What is the atomic number of an atom	The atomic number of an atom is the number of protons or electrons
What is the relative mass of a proton and neutron	1
What are isotopes	Isotopes are atoms of the same element with different numbers of neutrons. They have the identical chemical properties, but their physical properties, such as density, can differ
What is relative atomic mass	The relative atomic mass is the average of the mass numbers of different isotopes
Equation of Relative Atomic Mass	RAM = (mass number x abudance) + (mass number x abudance) / 100
How many electrons can be held in the first, second, third and fourth energy shells	Two in the first, eight in the second and third and 18 in the fourth
How are electrons arranged in an atom	The electrons in an atom are arranged in energy shells, which orbit the nucleas
What determines the chemical properties of an element	The number of energy shells and the number of electrons on the outermost shell determines the chemical propertes of an element
What was discovered in 1897 and by who	Thomson discovered that atoms contain tiny negative particles, and called it an electron
What happened to most of the alpha particles during the alpha scattering experiment and what did this show	Most of the alpha particles went straight through the gold atoms therefore atoms are mainly space
What did the deflected alpha particles in the alpha-scattering experiment show scientist	That the centre of an atom must have a positive charge, since the alpha particles that come close are repelled and change direction
What did the alpha particles that bounced straight back in the alpha-scattering experiment show scientist	Sometimes an alpha particle bounced straight back which means that the centre of an atom must contain a great deal of mass, this is now called the nucleas
Who discovered the neutron	James Chadwick discovered the nucleas also contains neutral particles called neutrons
Why was the periodic table of elements developed	The periodic table of elements developed as chemists tried to classify the elements, it arranges them in an order so simmilar elements are grouped together
Why is it called the periodic table of elements	It is named the periodic table of elements because of the regularly repeating patterns in the properties of elements
Why were there gaps in Mendeleev's periodic table	Mendeleev's periodic table left gaps for the unknown elements, which when discovered matched his predictions.
What is similar about elements in the same group	All the elements in a group have simmilar chemical properties. This is because all elements in a group have the same number of electrons in their outer energy level.
How did Dobereiner group the elements	Dobereiner group the elements in traids that had simmilar chemical properties
How did Newland group elements	Newland grouped elements in octaves and arrange elements in order of atomic mass so that every eighth element has similar chemical properties
What differences are there between the Mendeleev's and the modern periodic table	Element are now arranged in order of atomic number instead of atomic mass which beacuse elements could appear in the wrong order due to isotopes. Group 0 was not fully discovered during Mendeleev's time
Why are the noble gases unreactive	The noble gases in Group 0 are unreactive because of their very stable electron arrangement, a full outer shell
What is the boiling point trend of the noble gases	The boiling point increases as the relative atomic masses increase, going down the group
Why do metals react	Metals react to lose electrons to achieve a full outer energy level which gives them the same electronic structure as a noble gas. Metals always form positive ions
What are the elements in group one called	The elements in Group 1 of the periodic table are called the alkali metals.
What is the boiling point trend of the alkali metals	Their melting or boiling points decrease going down the group
What is the reactivity trend of the alkali metals	The reactivity of the alkali metals increases going down the group
Equation of alkali metals reacting with water	Metal(s) + Water(l) = Metal hydroxide(aq) + Hydrogen(g)
How do the alkali metals react with water	The metals all react with water to produce hydrogen and an alkaline solution containing the metal hydroxide
What ions do the alkali metals produce in reactions	They form 1+ ions in reactions to to make ionic compounds. These are generally white and disslove in water, giving colourless solutions
What charge do the halogens form with metals	The halogens all form ions with a single negative charge in their ionic compounds with metals
How do halogens bond with other non-metals	The halogens form covalent compounds by sharing electrons with other non-metals
What can a more reactive halogen do to a less reactive halogens	A more reactive halogen can displace a less reactive halogen from a solution of it's salt
What is the reactivity trend of the halogens	The reactivity of the halogens decreases going down the group
What is the boiling point trend of the halogens	The melting and boiling points increase going down the group
What are the three factors to include when writing about reactivity trends	The size of the atom, the number of occupied energy shells, which provide a shielding effect and the nuclear charge
Explain the reactivity trend for Group 1 metals	The reactivity increases going down the group because the size of the atom increases, which increases the distance of the outermost negatively charged electron from the positively charged nucleus which reduces the electrostatic forces of attraction. The inner shells create a shielding effect which also reduces the electrostatic forces of attraction. This outwieighs the increased nuclear charge due to the extra protons in the nucleus and therefore electrons are easier to lose going down the group and the elements are more reactive
Explain the reactivity trend for Group 7 non-metals	The reactivity decreases going down the group because the size of the atom increases, which increases the distance between the outermost negatively charged electrons from the positively charged nucleus which reduces the electrostatic forces of attraction. The inner shells create a shielding effect which also reduces the electrostatic forces of attraction.This outwieighs the increased nuclear charge due to the extra protons in the nucleus and therefore electrons are harder to gain going down the group and the elements are less reactive.
Compare properties between the alkali metals and the transition metals	Compared with the alkali metals, transition metals have higher melting points and densites. They are also much stronger and harder but are much less reactive.
How do the transition elements react with oxygen or water	The transition elements do not react vigorously with oxygen or water
What ions do transition elements form	Transition elements can form different ions with different charges, in compounds that are often coloured
How are transition elements used industrially	Transition elements and their compounds are important industrial catalyst.
What are the three states of matter	The three states of matter are solids, liquids and gases
Describe the particles of a solid	The particles in a solid are packed closely together, in a regular pattern and vibrate around fixed position, they are also hard to compress
Describe the particles in liquid	The particles in a liquid are close together but can slide over each other in random motion, they are hard to compress and take the shape of the container
Describe the particles in a gas	Gases are easy to compress, because the particles in gases are widely spaced. Gases spread out and fill the space of the container because the particles in a gas move at random speed and random motion
Describe the energy transfer during melting and boiling	In melting and boiling, energy is transferred from the surroundings to the substance
The stronger the forces of attraction between the particles...	The more energy needed to break them and the higher the melting point
What are the limitations of the simple particle model	Firstly, the simple particle model assumes that all particles are solid spheres and that there are no forces between particles
What do elements react to form and how	Elements react together to form compounds by gaining, losing or sharing electrons
How are ionic compounds held together	Ionic compounds are held together by strong electrostatic forces of attraction between their oppositely charged ions. This is called ionic bonding
Describe ionic bonding between Group 1 metals and Group 7 non-metals	Group 1 metals lose 1 electron forming a 1+ ion and Group 7 non-metals gain 1 electron forming a 1- ion. Both ions now have a full outer energy level
Describe ionic bonding between Group 2 metals and Group 6 non-metals	Group 2 metals lose 2 electron forming a 2+ ion and Group 6 non-metals gain 2 electron forming a 2- ion. Both ions now have a full outer energy level
Can ionic compounds conduct electricity	Ionic compounds will conduct electricity when molten or dissolved in water. This is because their ions can then become mobile and can carry the charge through the liquid
Why can't ionic compounds conduct electricity when molten	Ionic compounds cannot conduct electricity when solids because the ions cannot move to carry the charge, they are locked in place by the strong electrostatic forces of attraction
Why do gaint ionic lattice have a high melting point	It takes a lot of energy to break the many strong ionic bonds, operating in all directions, that hold a giant ionic lattice together. So ionic compounds have a high melting and boiling point and are always solids at room temperature
How are covalent bonds formed	Covalent bonds are formed when atoms of non-metals share pairs of electrons with each other
What counts as one covalent bond	Each shared pair of electrons counts as a covalent bond
What are the structures of covalent compounds	Many substances containing covalent bonds consist of simple molecules but some have giant covalent structures
What is common about melting and boiling points of small covalent structures and why	Substance made up of simple molecules have low melting and boiling points due to the weak intermolecular forces between molecules therefore it does not take much energy to break the bonds for the melting or boiling to occur. They are usually gases or liquids at room temperature
Can simple covalent molecules conduct electricity and why	Simple molecules have no overall charge, so they cannot carry an electrical charge, therefore substances made of simple molecules do not conduct electricity
Why do gaint covalent molecules have a high melting point	It takes a lot of energy to break the many strong covalent bonds, that hold giant covalent molecules together. So gaint covalent molecules have a high melting point and are always solids at room temperature
What element is diamond formed from	Diamond is formed from the element carbon
Why does diamond have a high melting point	Diamond forms 4 covalent bonds on each carbon atom which allows it to form a network of atoms held together by strong covalent bonds in a giant covalent structure, because of this it takes a great deal of energy to melt diamonds
Can diamond conduct electricity	Diamound cannot conduct electricity because there are no free electrons to carry the electrical charge due to the 4 covalent bonds of each carbon atom
What are the properties of giant covalent structures	Giant covalent structures have very high melting and boiling points. They are insoluble in water and do not conduct electricity (apart from graphite)
Why does silicon dioxide have a high melting and boiling point	Silicon dioxide has a high melting and boiling point due to the many strong covalent bonds that need to be broken which takes a great deal of energy
Why is graphite soft and slipperly	Graphite contains giant layers of carbon atoms with 3 covalent bonds which forms a layer of hexagonal rings. However ther are no covalent bonds between layers. This means that layers of graphite can slide over each other making it soft and slippery
Why does graphite have a high melting and boiling point	Graphite has a high melting and boiling point due to the many strong covalent bonds that need to be broken, which takes a great deal of energy
Can graphite conduct electricity and thermal heat	Graphite can conduct electricity and thermal energy because of the delocalised electrons that can travel through layers carrying an electrical charge or thermal energy
What is graphene	Graphene is a single layer of graphite and so is just one atom thick
What the properties and uses of graphene	Graphene is an excellent conductor of electricty because it has delocalised electrons, which will be useful in the electronics industry. Graphene is also very strong due to the many covalent bonds make it useful for new materials.
What are fullerenes	Fullerenes are molecules of carbon atoms which form large cage-like structures and tubes. They usually have hexagonal rings of carbon atoms but may also have rings with 5 or 7 carbon atoms.
What are fullerenes used for	Fullerenes can be used as transport mechanism for drugs to specific sites in the body, as catalyst or as reinforcement for compsite materials
What are the properties of carbon nanotubes	Carbon nanotubes have high tensile strength and are also excellent conductors of heat and electricity
What is one use for carbon nanotubes	Carbon nanotubes are used to reinforce materials such as tennis rackets
What are polymers made of	Polymers are made by joining together thousands of small, identical molecules called monomers. Monomers are often alkene molecules
Why are most polymers solids at room temperature	Most polymers are solids at room temperature due to the relatively strong intermolecular forces of attraction between polymer molecules
How are the atoms in metals arranged	The atoms in metals are closely packed together and arranged in regular layers. The electrons in the outer shell of each atom are delocalised and are free to move throughout the giant metallic lattice
Describe the bonding in metals	The metal atoms are held together by metallic bonds which are formed by the strong electrostatic forces attraction between the sea of delocalised negative electrons from the outer most shell of each metal atom and the positive metal ions.
Why do metals have a high melting and boiling point	Metals have a high melting and boiling point because it takes a great deal of energy to break the strong metallic bonds
Can metals conduct thermal energy and electricity	Metals can conduct electricity because the sea of delocalised electrons are charged and can carry an electrical current . Metals can also conduct thermal energy because the moving electrons can carry thermal energy
Can metals be bent and shaped	Metals can be bent and shaped beacuse the layers of atoms in a giant metallic structure can slide over each other
What are alloys	An alloy is a mixture of metals
Why is it more difficult to bend and shape alloys	An alloy is a mixture of metals. The different sizes of atoms distorts the layers, making it more difficult for them to slide over each other. Therefore alloys are harder than pure metals
Convert 1 millimetre to metres in s.f	1 x 10-3 metres
Convert 1 micrometre to metres in s.f	1 x 10-6 metres
Convert 1 nanometre to metres in s.f	1 x 10-9 metres
What is Nanoscience	Nanoscience is the study of small particles that are between 1 and 100 nanometres in size
What differenes are their between nanoparticles and the same material in bulk	Nanoparticles may have different properties from the same materials in bulk beacuse nanoparticles have a high surface area to volume ratio, with a high percentage of their atoms exposes at their surface
How can nanoparticles be used industrially	The use of nanoparticles instead of bulk materials mean that smaller quantities of materials are needed for example, catalysts needed for industrial processes
How can nanoparticles be used	Nanoparticles can be used in electronics, suncreams, catalysts, deodorants and can be used to deliver drugs reinforced by nanotubes
What are potential issues are their with the use of nanoparticles	It is possible that nanoparticles can be absorbed into the body and enter our cells, which can cause concern because the long term effects of this are unknown. There are also environmental issues
Name the advantage and disadvatage of dot and cross diagrams	One advantage of dot and cross diagrams is that it is very clear where the electrons are coming from. One disadvatage is that the diagrams do not tell you about the shape of the molecule
Name the advantage and disadvatage of stick diagrams	One advantage of stick diagrams is that they show you the covalent bonds in the molecule. One disadvantage is that the diagrams do not show the electrons in the outermost shell
Name the advantage and disadvatage of ball and stick diagrams	One advantage of ball and stick diagrams is that it clearly allows us to see the ions in 3 dimensions. The disadvatage of the diagrams is that the ions are shown as widely spaced
Name the advantage and disadvatage of spacefilling diagrams	One advantage of spacefilling diagrams is that the ions are shown as closely packed. The disadvantage is that it is difficult to see the three dimensional packing
Name the main disadvantage of space filling diagrams and ball and stick diagrams	The main disadvantage of space filling and ball and stick diagrams is that they only show a small part of the giant crystal lattice
What is the Law of Conservation of Mass	No atoms are lost or made during a chemical reaction so the mass of products is equal to the mass of reactants
What is atom is used as a reference point for calculating relative atomic masses	The masses of atoms are compared by measuring them relative to atoms of carbon-12
Equation of Moles that links Mass and Mr	Moles = Mass / Mr
What is the overall charge of an ionic compound	In an ionic compound, the charges on the ions have to cancel out to leave an overall charge of zero
What is relative formula mass	The relative formula mass of a compound is the sum of the relative atomic masses of the atoms in numbers shown in the formula
What is Avogadro's constant	6.02 x 1023
Define Avogadro's constant	Avogadro's constant is the number of atoms or molecules in one mole of a substance, which is equal to 6.023 Ã— 1023.
What is the limiting reactant in a chemical reaction	The limiting reactant is the reactant in a chemical reaction which gets completely reacted first
What is the excess reactant in a reaction	The excess reactant is the reactant in a chemical reaction with greater amount than necessary to react completely with the limiting reactant
Define concentration	The concentration of a solution shows you the mass of a solute in in a given volume of solution
Equation of concentration that links mass and volume	c = m / v
Explain what it means if a solution is more concentrated	A more concentrated solution has more solute in the same volume of solution than a less concentrated solution
Equation of percentage yield	% yield = actual mass / theoretical yield x 100%
What is meant by the yield of a chemical reaction	The yield of a chemical reaction describes how much product is made
What is meant by the percentage yield of a chemical reaction	The percentage yield of a chemical reaction describes how much product is made compared with the maximum amount that could be made (100%)
What factors can affect the yield of a chemical reaction	Factors affecting the yield of a chemical reaction include product being left behind in the apparatus, reversible reactions not going to completion, some reactants may produce unexpected reaction, and losses in separating the products from the the reaction mixture
What is atom economy	Atom economy is a measure of the amount of starting materials that end up as desired products. By minimising the production of unwanted products, money is saved and sustainability is increased by not wasting resources
Why is it important to increase atom economy in industrial processes	It is important to increases atom economy in industrial processes to conserve the Earth's resources, minimise pollution and to save money
Equation of atom economy	atom economy = Mr of desired products / Mr of all reactants
Eqaution of concentration	c = n / v
Convert 1 cm3 to dm3	1000 dm3
What volume of any gas is considered a mole	One mole of any gas occuppies a volume of 24 dm3 at room temperature (20 oC) and room pressure (1 atomsphere)
Equation of number of moles of gas	n = vol / 24
Equation of metal reacting with oxygen	metal + oxygen = metal oxide
Explain the reactions of metals with oxygen	When a metal reacts with oxygen it will form a metal oxide and an oxidation reaction takes place because the metal atoms have been oxidised
What type of reaction loses oxygen	Losing oxygen is a reduction reaction
What type of reaction gains oxygen	Gaining oxygen is a oxidation reaction
What type of reaction both loses and gains oxygen	Losing and gaining oxygen is a redox reaction
Equation of Group 1 metal reacting with water	metal + water = metal hydroxide + hydrogen
How are metals ordered in the reactivity series	The metals can be placed in order of reactivity by their reactions with water and dilute acid
What gas is given off when metals react with water or acid and how do you test for it	Hydrogen gas is given off if metals react with water or dilute acids. The gas pops with a lighted splint
Describe the reaction of Group 1 metals with water and dilute acid	Group 1 metals fizz, giving off hydrogen gas when they react with water, leaving an alkaline solution of metal hydroxide. Group 1 metals dangeroulsy expolde when reacing with dilute acid
What defines a metals reactivity	When metals react they lose electrons and form a positive ion. The reactivity of a metal depends on its ability to lose electrons and form a positive ion
What is oxidation	Oxidation is the loss of electrons
What is reduction	Reduction is the gain of electrons
Describe a displacment reaction with metals	A more reactive metal will displace a less reactive metal from its aqueous solution
Why are the non-metals carbon and hydrogen in the reactivity series	The non-metals carbon and hydrogen can be given positions in the reactivity series because they are commonly used in displacement reactions
What is displacement	A more reactive element will displace a less reactive element from its compound
Which metal is found in its native state	Gold and some other unreactive metals can be found in their native state
What is a metal ore	A metal ore contains enough of the metal to make it economic to extract the metal
On what condition are ores mined	Ores that are mined need to be concentrated before the metal is extracted and puried
How are metals extracted from their ores	Metals are extracted from their ores by reduction of their compounds in displacement reactions. The reactivity series helps you decide the best way to extract a metal.
What is the cheapest way to extract metals less reactive than carbon	The compounds of metals below carbon in the series can be reduced by carbon to give the metal element
How are metals more reactive than carbon extracted from their ores	Metals more reactive than carbon cannot be extracted using carbon instead they are extracted by electroysis of the molten metal compound
Equation of a metal reacting with acid	Metal + Acids = Salt + Hydrogen
OIL RIG	Oxidation is loss, Reduction is gain
Which ions do acids produce	Acids produce hydrogen ions (H+) in aqueous solution
What are bases	Bases are chemicals which can neutralise acids and produce water and a salt. They are insoluble in water. Bases which are soluble in water are also called alkalis
Which ions do alkalis produce	Alkalis produce hydroxide ions (OH-) in aqueous solutions
What does the pH of a substance tell us	The pH tells us the acidity or alkilinity of a solution. To determine pH you can use a pH probe or Universal indicator
Formula for Hydrochloric acid	HCL
Formula for Sulfuric acid	H2SO4
Formula for Nitric acid	HNO3
How does a salt from	A salt is a compound formed when the hydrogen in an acid is wholly or partially replaced by metal or ammonium ions
How are salts created	Salts can be made by reacting a suitable metal with an acid. The metal must be above hydrogen in the reactivity series, but not dangerously reactive
What are the products of a metal and an acid	The reaction between a metal and an acid produces hydrogen gas as well as a salt.
How can a sample of salt be made	A sample of the salt can then be crystallised out of the solution by evaporating off the water
What type of reaction is a metal reacting with an acid	The reaction between a metal and an acid is a redox reaction. The metal atoms lose electrons and are oxidised and hydrogen ions from the acid gain electrons and are reduced
Formula Equation for a Neutralisation reaction	Acid + Base = Salt + Water
How can a pure dry sample of salt be made from a neutralisation reaction	A pure, dry sample of the salt made in an acid-base reaction can be crystallised out of solution by evaporating off most of the liquid, and drying with filter paper
Formula for Sodium carbonate	Na2CO3
Formula for Calcium carbonate	CaCO3
Formula for Potassium carbonate	K2CO3
Word Equation for acid reacting with a metal carbonate	Acid + Metal carbonate = Salt + Water + CO2
What are the products of an acid reacting with a metal carbonate	When acids react with a metal carbonate, they make a salt, water and carbon dioxide
What is an alkali	An alkali is a soluble hydroxide, whic produce OH- ions when added to water
What are some acids some called strong acids and others called weak acids	Strong acids have a higher pH vaule then weaker acids of the same concentration. This is beacuse strong acids fully ionise in aqueous solutions and weak acids only partially ionise in aqueous solutions since the reaction is reversible so, some of the ions recombine to form the orginal molecule. Therefore their is a higher concentration of H+ ions are in strong acids than weak acids given the same concentration
What will increase if the pH vaule decreases by one	As pH decreases by one unit, the hydrogen ion concentration of the solution increases by a factor of 10
What does the concentration of an acid tell us	The concentration of an acid tells us the amount of acid molecules in a given volume of solution
What do we use Titration for	Titration is used to accurately measure which volumes of acid and alkali react together completely
What is an end point in Titration	The point at which a reaction between an acid and an alkali is complete is called the end point
Define Electroysis	Electroysis is the breaking down of ionic compounds, into new products using electricty
Why can't you carry out electroysis with solid electrolytes	Solid ionic compunds would not be able to conduct electricty because the ions are locked in place and are not free to move due to the strong electrostatic forces of attraction
Why can electroysis only occur when the electrolytes are molten or in solution	When an ionic compound is melted or dissolved in solution, the forces of attraction are broken and the ions are free to move and carry the electrical charge to the electrodes
Which ions move where in electroysis	In electroysis, positive ions move towards the cathode which is the negative electrode while negative ions move to the anode which is the positive electrode
What are the electrodes made of	The electrodes are often made of an unreactive substance, such as graphiteor platium metal. This is so the electrodes do not react with the electrolyte or the products made in electroysis
What happens ions meet the electrodes	When the ions meet the electrodes, electron exchange happens and this triggers a chemical reaction.
What happens at the anode	At the anode, the negative ions are oxidised which means they lose their extra electrons and become neutral atoms
What happens at the cathode	At the cathode, the positive ions are reduced which means they gain extra electrons and become neutral atoms
What does Aqueous solution mean	Aqueous solutions are dissloved in water
Which other electrolytes are involved in the electrolysis of aqueous solutions	Water molecules ionies forming hydrogen ions and hydroxide ions
What is produced at the cathode in the electrolysis of aqueous solutions	Hydrogen is produced at the cathode if the metal is more reactive than hydrogen
What is produced at the anode in the electrolysis of aqueous solutions	At the anode oxygen gas is given off, from discharged hydroxide ions produced from water or a halogen is produced if the electrolyte is a solution of a hailde
Half equation of hydrogen at the cathode	2H+(aq) + 2e- = H2(g)
Half equation of Hydroxide ion at the anode	4OH-(aq) = 2H2O(l) +O2(g) + 4e-
Half equation of chlorine ion at the anode	2Cl-(aq) = Cl2(g) + 2e-
What is brine	Brine is concentrated sodium chloride solution. The electroysis of brine is a very important industrial process
Word equation of the electrolysis of brine	Sodium chloride solution = Hydrogen gas + Chlorine gas + Sodium hydroxide solution
What are the products of the electrolysis of brine	When you eletrolyse sodium chloride solution or brine you get chlorine gas and hydrogen gas given off at the electrodes, and sodium hydroxide solution which is left in solution
What is produced at cathode in the electroysis of brine	The H+(aq) ions are attracted to the cathode and are reduced, so the hydrogen atoms will bond in pairs and will be given off as a gas from the cathode in preference to OH-(aq) ions
What is produced at the anode in the electroysis of brine	The Cl-(aq) ions are attracted to the anode and are oxidised, so the chlorine atoms will bond in pairs and will be given off as a gas from the cathode in peference to the OH-(aq) ions
Half equation of electroysis of brine at the anode	2Cl-(aq) = Cl2(g) + 2e-
Half equation of electroysis of brine at the cathode	2H+(aq) + 2e- = H2(g)
Equation of water ionising in electrolysis	H2O(l) <=> H+(aq) + OH-(aq)
How do you test for Chlorine gas in the electrolysis of Brine	Chlorine gas will turn blue litmus paper red and will then bleach, it turing it white
How do you test for Hydrogen gas in the electrolysis of Brine	The gas should be collected in a tube and a squeaky pop will be heared if the a lit splint is placed inside the tube
How do you test for sodium hydroxide solution in the electrolysis of Brine	Adding Universal indicator should turn the solution blue or purple
What is sodium hydroxide and chlorine used for	Sodium hydroxide is used in oven and drain cleaners. Chlorine is used to treat water and as a disinfectant. Both sodium hydroxide and chlorine are used to make bleach
What is Hydrogen used for	Hydrogen is used as a fuel
How is Aluminium extracted from its ore	Aluminium metal is extracted from the compound aluminium oxide, from the ore bauxite, by electrolysis
What is added to the aluminium oxide before electroysis	The aluminium oxide is mixed with molten cryolite to lower its melting point, reducing the energy needed to extract the aluminium which saves money
What are the electrodes, of the electroysis of aluminium oxide, made from	The cathode and anode are both made of graphite
What is the product at the cathode during the electrolysis of aluminium oxide	The Al3+(l) ions are attracted to the cathode and each ion is reduced, forming Al(l) atoms
What is the product at the anode during the electrolysis of aluminium oxide	The O2-(l) ions are attrated to the anode and are oxidsied, forming an oxygen molecule. CO2 is given off because the O2 reacts with the graphite electrodes
Half equation of the electroysis of aluminium oxide at the anode	2O2-(l) = O2(g) + 4e-
Half equation of the electroysis of aluminium oxide at the cathode	Al3+(l) + 3e- = Al(l)
Why does the graphite anode need to be change in the electroysis of aluminium oxide	The graphite anodes are replaced regularly as they gradually burn away because the oxygen molecules being produced reacts with the hot carbon anodes, forming carbon dioxide gas
Why is the electroysis of aluminium oxide expensive	Melting the compounds such as aluminium oxide requires a great deal of energy and alot of energy is needed to produce the electric current
What is an exothermic reaction	A reaction in which energy is transferred from the reacting substances to their surroundings is called an exothermic reaction
What is an endothermic reaction	A reaction in which energy is transferred to the reacting substances from their surroundings is called an endothermic reaction
What is the Law of conservation of energy	Energy is conserved in chemical reactions. it is neither created nor destroyed
When can reaction only occur	Reactions can only occur when the particles collide with each other and they have to do that with sufficient energy
What is activiation energy	Activiation energy is the minimum amount of energy required before colliding particles of reactants have sufficient energy to cause a reaction
How can we use exothermic reactions	Exothermic changes can be used in hand warmers and self-heating cans. Crystallisation of a supersaturated solution is used in reausable warmers. However disposable, one-off warmers heat up the surroundings for longer.
How can we use Endothermic reactions	Endothermic changes can be used in instant cold packs for sports injuries
Endothermic	Bond breaking
Bond breaking	Endothermic
Exothermic	Bond making
Bond making	Exothermic
What is bond energy	Bond energy is the energy required to break the bonds between two atoms. It is measured in KJ/mol
Describe the energy when bonds between atoms form	When new bonds are formed between atoms in a chemical reaction, energy is released
Describe the energy when bonds between atoms are broken	In chemical reactions, energy must be supplied to break the bonds between atoms in the reactants.
How can you calculate overall energy change in a chemical reaction	You can calculate the overall energy change in a chemical reaction using bond energies
Describe energy in an endothermic reaction	In an endothermic reaction, the energy released when new bonds form is less than the energy aborbed when when bonds are broken
Describe energy in an exothermic reaction	In an exothermic reaction, the energy released when new bonds are formed is greater than the energy absorbed when bonds are broken
Describe how two metals can form a simple cell	When two metals are dipped in salt solution and joined by a wire, the more reactive metal will donate electrons to the less reactive metal. This forms a simple electrical cell
Why don't cells produce energy forever	A cell can only produce electricity for a certin period of time. Eventually the chemicals in a the cell run out and the reaction stops
What can increase the voltage created by a cell	The greater the differencr between the reactivity of metals, the greater the potential difference produced by the cell. The electrolyte also affects the potential difference
What is a battery	A battery contains two or more cells connected in series to produce a greater voltage
Why can't alkaline batteries be recharged	In alkaline batteries, at some point, the reactants in the batteries run out and no more electricity is produced. There is no way to reverse the reaction, so these are non-rechargeable batteries
Why can rechargeable batteries be used when the reactants have run out	Rechargeable batteries can be recharged. We can reverse the chemical reactions when we apply an electrical current
How do electron move in a cell	The electrons flow from the more reactive metal which is the anode to the less reactive metal which is the cathode
Half equation of Hydrogen fuel cell at the anode	O2(g) + 2H2O(l) + 4e- = 4OH-(aq)
Half equation of Hydrogen fuel cell at the cathode	2H2(g) + 4OH-(aq) = 4H2O(l) + 4e-
How is hydrogen produced from hydrogen fuel cells	Hydrogen gas is oxidised and provides a source of electrons in the hydrogen fuel cell, in which the only watse product is water
What are the advantages of Hydrogen fuel cells	- Hydrogen fuel cells will produce electricity for as long as you provide hydrogen  -Hydrogen fuel cells do not get less effiecient the longer they run  -Hydrogen fuel cells can be a source of drinkable water
- Hydrogen fuel cells will produce electricity for as long as you provide hydrogen  -Hydrogen fuel cells do not get less effiecient the longer they run  -Hydrogen fuel cells can be a source of drinkable water	What are the advantages of Hydrogen fuel cells
What are the disadvantages of Rechargeable batteries	- Rechargeable batteries run out and need to recharged - Rechargeable batteries store less electricity, the more charging cycles they go through and eventually need to be replaced
- Rechargeable batteries run out and need to recharged - Rechargeable batteries store less electricity, the more charging cycles they go through and eventually need to be replaced	What are the disadvantages of Rechargeable batteries
What are the disadvantages of Hydrogen fuel cells	- Hydrogen fuel cells run on hydrogen which is an explosive gas and is very difficult to store safely - Hydrogen fuel cells produce a relatively low potential difference or voltage so serval are needed together
- Hydrogen fuel cells run on hydrogen which is an explosive gas and is very difficult to store safely - Hydrogen fuel cells produce a relatively low potential difference or voltage so serval are needed together	What are the disadvantages of Hydrogen fuel cells
What are the advantages of Rechargeable batteries	- No dangerous fuels are required with rechargable batteries. Some types of rechargeable batteries can catch fire if not manaufactured correctly - Rechargeable batteries can produce a greater potential difference than a hydrogen fuel cell
- No dangerous fuels are required with rechargable batteries. Some types of rechargeable batteries can catch fire if not manaufactured correctly - Rechargeable batteries can produce a greater potential difference than a hydrogen fuel cell	What are the advantages of Rechargeable batteries
Name one alternative to fossil fuels	Hydrogen is one alternative fuel. It can be used in fuel cells to power vechicles
How can you monitor the rate of a chemical reaction	We can find out the rate of a reaction by monitoring the amount of reactants used up over time. Alternatively, you can find out the rate of reation by measuring the amount of products made over time
How can you calculate the rate of reaction from a curve	To calculate the rate of reaction at a specifc time, draw the tanget to the curve, then calculate its gradient
Equation of mean rate of reaction for quantity of reactants used	mean rate of reaction = quantity of reactant used / time
Equation of mean rate of reaction for quantity of product formed used	mean rate of reaction = quantity of product formed / time
What does a steep slope on a rate of reaction graph tell you about the molecules	The steeper the slope, the faster the reaction as there is alot of product of being made in a short amount of time. This is because there is a large number of reactant molecules reacting to form the product. This means there is a large number of collisions per second
What does a gradual slope on a rate of reaction graph tell you about the molecules	A gradual slope tells us that the rate of reaction is slowing down because alot of the reactant molecules have turned into the product. This means that there are fewer reactant molecules available to react so there will be a smaller number of collions per second
What does a flat slope on a rate of reaction graph tell you aboout the molecules	At this point the reaction has as stopped this is because all the reactant molecules have already reacted. This means that the number of collisions per second is now zero
Define Collision Theory	Chemical reactions can only take place when the reacting particles collide with each other. The collisions must have sufficient energy to cause a reaction to take place
What is the rate of reaction determined by	The rate of reaction is determined by the frequency of successful collisions per second
What effect does increasing concentration of reactants have on the rate of reaction	Increasing the concentration of reactants in solution increases the frequency of collision between particles and so increases the rate of reaction. This means that the rate of reaction is proportinal to the concentration
What effect does increasing surface area of reactants have on the rate of reaction	The rate of a chemical reaction increases if the surface area to volume ratio of any solid reactant has increased. This increases the frequency of successful collisions between reacting particles
What does a large surface area : volume ratio mean	Smaller sized blocks have a greater surface area : volume ratio than larger blocks. This means that they have more particles on the surface so there are more collisions per second. This increase the rate of reaction
What effect does increasing temperature of reactants have on the rate of reaction	Increasing the temperature increases the rate of reaction because particles collide more frequently and more energetically. There would be more collisions occuring in a given time, because a higher proportion of particles have energy greater than the activation energy
What effect does using a catalyst have on the rate of reaction	Catalysts increase the rate of chemical reaction but are not used up during the reaction. When a catalyst is present, the particles require less energy to cross the activation energy barrier. This means that more particles can successfully collide per second
Why are catalysts useful for industrial processes	Catalysts are used whenever possible in industry to carry out reactions quickly without needing to increase the temperature and this reduces energy costs
Define a catalyst	Catalysts increase the rate of reaction by providing a different pathway for the reaction that has a lower activation energy
Why aren't catalysts included in chemical equations	We do not include catalysts in the chemical equation for a reaction. That is because they are not used up in the reation. Catalysts are not reactants
What effect does increasing pressure of reactants have on the rate of reaction	Increasing the pressure of reacting gases increases the frequency of collisions, and so increases the rate of reaction. This is because there are more particles of gas in a given space which increases the chance they will collide and react
Can one catalyst be used for all reactions	No, different catalysts are needed for different reactions
What is meant by a reversible reaction	In a reversible reaction, the products of the reaction can react to make the original reactants
Describe the types of reactions in reversible reactions	If a reversible reaction is exothermic in one direction, it is endothermic in the opposite direction.
Describe the energy transfers in reversible reactions	In any reversible reactions, the amount of energy transferred to the surroundings when the reaction goes in one direction is exactly equal to the energy transferred back when the reaction goes in the opposite direction
Describe the rate of reaction for a reversible reaction is a closed system	In a closed system, the rate of the forward and reverse reaction is equal at equilibrium
What is a closed system	A closed system is a sytem in which no particles can get into or out of the system, so typically a sealed vessel
What is the effect of changing conditions in a system that is equilibrium	If a system is at equilibrium and change is made to the conditions, then the system responds to counteract the change. This is called Le Chatelier's Principle
What is dynamic equilibrium	When the rate of the forward reaction is equal to the rate of the reverse reaction the amount of reactants and products remian constant. This is called a dynamic equilibrium
In which conditions can dynamic equilibrium occur in	A dynamic equilibrim can only occur in a closed system
What happens if you increase the temperature of a reversible reaction in a closed system	If you increases the temperature of a system, then the equilibrium shifts the endothermic side to reduce the temperature. This is because the system was at equilibrium and when change is made to the conditions, then the system responds to counteract the change
What happens if you decrease the temperature of a reversible reaction in a closed system	If you decrease the temperature of a system, then the equilibrium shifts the exothermic side to increases the temperature. This is because the system was at equilibrium and when change is made to the conditions, then the system responds to counteract the change
What happens if you increase the pressure of a reversible reaction in a closed system	If you increase the pressure on a reversible reaction at equilibrim, the position of the equilibrium shifts to the side with the smaller number of molecules
What happens if you reduce the pressure of a reversible reaction in a closed system	If you reduce the pressure on a reversible reaction at equilibrim, the position of the equilibrium shifts to the side with the larger number of molecules
What happens if you change the pressure of a reversible reaction in a closed system with the same number of moles on both sides	If we have the same number of moles on both sides, the changing pressure has no effect on the position of equilibrium
What happens if you increase the amount of reactant of a reversible reaction	If you add more reactants to a reversible reaction, the equilibrium will shift to the right to remove the reactants and make more product
What happens if you remove the amount of product of a reversible reaction	If you remove the products of a reversible reaction, the equilibrium will shift to the right to replace lost products. By continually removing product, the forward reaction can be maintained
Why are single colour indicators used instead of universal indicator	Single colour indicators are used because the end point is then very clear e.g. pink to colourless. Universal indicators have a range of colours so it is not often clear when the solution has reached its end point for example green or blue
What is Crude oil	Crude oil is a mixture of many different compounds. Most of the compounds are hydrocarbons
What are Hydrocarbons	Hydrocarbons are molecules made up of only hydrogen and carbon atoms only
What are Alkanes	Alkanes are saturated hydrocarbons that contain as many hydrogen atoms as possible in their molecules
General formula for Alkanes	CnH(2n+2)
Name the first 4 Alkanes	Methane, Ethane, Propane, Butane
Describe the distillation of Crude oil	The fractional distillation of crude oil takes place in a tower called a fractionating column. Firstly, the crude oil is heated and fed into the bottom of the column as a hot vapour. The column is kept very hot at the bottom and much cooler at the top, so the temperature decreases going up the column. The gases move up the column and the hydrocarbons condese when they reach their boiling points. The liquid fractions are then removed.
How is crude oil separted	Crude oil is separted into fractions. Fractions contain a similar number of carbon atoms. This is beacuse very longer chain hydrocarbons have very higher boiling points and are removed from the bottom of the column and shorter chain hydrocarbons have very low boiling points and are removed from the top of the column
Why are short chain hydrocarbons useful	Short chain hydrocarbons make good fuels as they ignite easily and burn well, with less smoky flames, they are very flammable
How are are the hydrocabons removed from the column	Hydrocarbons with the smallest molecules have the lowest boiling points. They are piped out of the cooler top of the column as gases. At the bottom of the column, the fractions have high boiling points. They cool to form very thick liquid or soilds at room temperature
What are feedstock	A feedstock is a chemical that is used to make other chemicals and sre used for the petrochemical industry
Describe the viscousity of Crude oil	As the size of the hydrocarbon molecules increases the molecules get more viscous
Describe flammability of  Hydrocarbons	As the size of the hydrocarbon molecules increases, the hydrocarbon becomes less flammable. Long chain hydrocarbons are very difficult to burn
Describe the boiling point of hydrocarbon	As the size of the hydrocarbon molecules increases, the boiling point also increases. Very long chain hydrocarbon have very high boiling points
How do Hydrocarbons provide energy	Hydrocarbon fuel releases energy when combusted. During combustion the carbon and hydrogen atoms in the fuel react with oxygen. The carbon and hydrogen are oxidised. If the oxygen is unlimited, this reaction produces carbon dioxide and water and this is called complete combustion
Balanced Equation of the complete combustion of propane	C3H8(g)+ 5O2(g) = 3CO2(g) + 4H2O(g)
What is incomplete combustion	When there isn't enough oxygen during the combustion hydrocarbons, eg inside an engine, there is incomplete combustion. Instead of all the carbon in the fuel turning into CO2, carbon monxide gas, is also formed. Carbon monoxide is a toxic gas
Why is carbon monoxide gas toxic to humans	Carbon monoxide is a colourless and odourless toxic gas. Red blood cells bind to the gas and carry it around in your blood instead of oxygen
How do you test for water	Water will turn blue cobalt chloride paper pink
How do you test for CO2	Carbon dioxide turns limewater cloudy
What is cracking	In cracking, a large alkane is broken down to produce smaller, more useful molecules
How are hydrocarbons cracked	Large hydrocarbon molecules can be broken down, by catalytic cracking which uses heat and a catalyst. The catalyst provides an alternative path with a lower activation energy. Or by steam cracking which uses heat and steam
What are the products of craking hydrocarbons	Cracking produces saturated hydrocarbons, which are used as fuels, and unsaturated hydrocarbons called alkenes, which are used to make polymers and chemicals
Why are large hydrocarbons cracked	Large hydrocarbons are not in high demand, as they are difficult to vaporise and do not burn easily making them poor fuels
How do you test for alkenes	Alkenes will turn orange bromine water colourless
How can we distinguish alkenes and alkanes	Alkenes are more reactive then alkanes, so a reaction with bromine water is used to test the hydrocarbon. If the hydrocarbon turns the orange bromine water colourless than the hydrocarbon is an alkene. Alkanes do not react with bromine water
What is the funtional group of alkenes	Alkenes are unsaturated hydrocarbons which are have a onecarbon to carbon double bond.This means that all of the alkenes react in the same way
General Formual for Alkenes	CnH2n
What is a functional group	The words functional group mean the part of a molecule that determines how it reacts
What is a homologus series	A family of organic compounds with the same functional group is called a homologus series
Describe the combustion of alkenes	Combusting an alkene produes carbon dioxide and water and also unburnt carbon particles because of incomplete combustion. Alkenes burn in air with a smoky yellow flame. They also release less energy per mole in combustion compared to alkanes, so are not used as fuels
Equation of ethene reacting with bromine	C2H4 + Br2 = C2H4Br2
What are the products of reacting an alkene with hydrogen	Reacting an alkene with hydrogen produces an alkane
Describe the hydration of ethene	Ethene gas can be cracked to react with steam to make ethonal. The reaction requires energy to heat the gases and to generate a high pressure. The temperature must be around 300oC and the pressure around 70 atmosphere. Phosphoric acid is used as a cataylast and the reaction is reversible. To increase the yield of ethanol, any unreacted ethene and steam are passed back through the catalyst
How do alkenes react	Alkenes react with halogens, hydrogen and water by adding atoms across the carbon double bond, forming a saturated molecule
What is the functional group of alcohols	The homologous series of alcohols contain the OH functional group
What are the advantage and disavantage of producing ethonal by hydration	One advantage of producing ethanol by hydrating ethene is that the reaction produces a high yield of ethanol. However the reation requires a high temperature and the ethene comes from non-renewable crude oil
Describe an alternative way to make ethanol	In fermentation, a sugar solution such as glucose can be mixed with yeast. The yeast coverts the sugar solution to a solution of ethonal. Carbon dioxide gas is also produced. The temperature should be around 30oC. The reation must take place in anaerobic conditions
What are the advantages and disadvantages of producing ethanol my fermentation	The low temperature means that he reaction does not require a lot of energy. The sugar for this reaction comes from plants and is therefore renewable. However the product would be an aqeous solution of ethanol, which has to be distilled and that requires energy
Describe the solubility of alcohols in water	Alcohols are soluble in water and form neutral solutions. As the number of carbon atoms increases, the solubility decreases
Describe the reaction of alcohols with sodium	Alcohols react with sodium metal to form a solution of sodium alkoxide and hydrogen gas is given off
Describe the oxidation of an alcohol	When alcohols react with oxidising agents, such as potassium dichromate, they produce a carboxylic acid and water. The same reaction takes place if the ethanol is left exopsed to the air. Microbes in the air produce ethonic acid from ethanol
Describe the combustion of alcohols	Alcohols release energy when combusted. Combusting an alcohol in air produces carbon dioxide and water
How are alcohols used	Alcohols are used as solvents and fuels and ethonal is the main alcohol in alcoholic drinks.
What is the funtional group of the carboxylic acids	The homologous series of carboxylic acids contain the -COOH functional group
General Word Equation of acid reacting with metal carbonate	Metal carbonate + acid = salt + water + carbon dioxide
Why are carboxylic acids called weak acids	Carboxylic acids only partially ionise their H+ ions in aqueous solutions. The reaction is also reversible so, some of the ions recombine to form the orginal molecule. Therefore their is a higher concentration of H+ ions in strong acids than in carboxylic acids given the same concentration
Describe the reaction of ethanoic acid and sodium carbonate	The reaction of ethanoic acid and sodium carbonate produces the salt sodium ethanoate, carbon dioxide gas and water
What are the products of carboxylic acids reacting with alcohols	Carboxylic acids react with alcohols to produce esters and water in a reversible reaction in the presence of a strong acid catalyst such as sulfuric acid
How are esters useful	Esters have a distintive smells because they are volatile (evaporate easily). This makes them ideal for use in perfumes and food flavourings
How are polymers made	A polymer is made by joining together thousands of small, identical molecules called monomers. The monomer molecules are joined together to form the polymer
What type of monomers are used to create addition polymers	In addition polymers, the monomers are alkenes. Monomers have a double carbon to carbon bond which is replaced by a single carbon to carbon bond when the polymers form. This is called addition polymerisation
What are plastics made from	The plastics used in everyday life are made up of huge covalently bonded molecules made from lots of small monomer molecules joined together.
What is a condensation polymer	Condensation polymers are made from monomers. In condesation polymer, the monomers are not alkenes. When these monomers react, small molecules are lost such as water or hydrogen chloride
State the differences between addition and condensation polymers	In addition polymerisation, there is only one product formed in the reaction, the polymer, whereas in condensation polymerisation there are two different products. The main product is the polymer, but there is a small molecule being given off such as water or hydrogen chloride
General word equation to make a polyester	Diol + Dicarboxylic acid = Polyester + water
How are condensation polymers formed	Condensation polymers are formed by two different monomers. Each monomer has two of the same functional groups
How are polyesters formed	To make a polyester you would react one diol monomer with an OH group at each end and a dicarboxylic acid monomer with a COOH group at each end. The monomers link together as they polymerise by ester links and a water molecule is given off
What do monosaccharides polymerise to make	Simple carbohydrates such as monosaccharides polymerise to make polymers such as starch and cellulose
What are amino acids	Amino acid molecules have two different functional groups which commonly are from the amine group and the carboxylic acid group. Amino acids can react to form a condensation polymer due to the two different functional and they also produce water
What do amino acids react to form	Amino acids react together during condensation polymerisation to make polypeptides and proteins made of long sequences of different monomers
What are polymers	Polymers are very large molecules created by reacting  a large number of similar molecules, called monomers
What are the conditions in which High density polyethene is formed	High density polyethene, which is used to make fuel tanks, polymerises at low temperature and pressure
What are the conditions in which low density polyethene is formed	Low density polyethene, which is used to make plastic bags, polymerises at high temperature and pressure.
What happens when thermosoftening polymers are heated	Thermosoftening polymer soften and melt when heated. This is because the individual chains of the polymer are held together by weak intermolecular forces. When heated, these bonds break, allowing the chains to slide over one another.
What happens when you heat thermosetting polymers	Thermosetting polymers do not soften when heated. This is because the individual chains of the polymer are joined together with cross links, which are covalent bonds between the chains. As these bonds are of similar strength to all of the other covalent bonds present, strong heating will result in chemical decomposition of the polymer, rather than reversible melting.
What is condensation polymerisation	Condensation polymerisation involves monomers with two functional groups. When these types of monomers react they join together, usually losing small molecules such as water, and so the reactions are called condensation reactions.
What are polypeptides	Polypeptides are the main component of proteins. They are short chains of amino acid monomers linked by peptide bonds.
What is DNA made from	DNA is made up from monomers called nucleotide
Describe the structure of DNA	DNA molecules consist of a double helix made up of two long polymer strands of nucleotides and are held in place by intermolecular forces down the length of the strand.There are four different nucleotide monomers that can react with each other to form DNA polymer.
What are nucleotides	The nucleotides are based on the sugar deoxyribose, bonded to a phospatye group and a base. There are four possible bases that bond to the sugar. These are adenine, thymine, cytosine, guanine
What does DNA stand for	Deoxyribonucleic acid
The Harber process takes place at 450oC, under 200 atmospheric pressure in the presence of an iron catalyst. The ammonia made is regularly condesed and removed.                                                                             N2(g) + 3H2(g) <=> 2NH3(g)   Explain why these conditions and processes are in place, identifying clearly the compromises made                                                                                                    [6 marks]	The reaction is exothermic so a low temperature would shift the equilibrium to the right. However this would slow down the rate of reaction so a compromise is used to ensure the particles have the minimum amount of energy required to collide. A high pressure is used as it speeds up the rate of the reaction as there are more reacting particles in a given volume. It also shifts the equilibrium to the right as there are 4 moles on the left and 2 on the right. A catalyst is used as it speeds up the rate of both the forward and reverse reaction without getting used up. This makes it a cheap way to increase the rate. A catalyst provides an alternative path with a lower activation energy. Ammonia is removed as this will drive the reation in the forward direction, increasing the yield
What is meant by purity	Pure substances can be compounds or elements, but they contain only one substance.
What is meant by impuritiy	An impure substance is a mixture of two or more different elements or compounds
Describe the melting and boiling points of pure substances	Pure elements and compounds melt and boil at specific temperatures, and these fixed points can be used to identify them
How can you distinguish from pure and impure substance	Melting and boiling point data can be used to distinguish pure substances that have fixed melting and boiling points from impure mixtures that melt or boil over a range of temperatures.
How can you test the purity of a sample	The purity of a sample can be tested by measuring the melting and boiling points and comparing it with the melting and boiling of the pure sunstance which can be found in a data book. The closer your measured vaule is to the actual melting and boiling points, the purer your sample is
How do impurties affect the melting and boiling points of a sample	Impurities in your sample will lower the melting points and increase the melting range of a substance. Impurities in your sample will also increase the boiling point and may result in your sample boiling at a range of temperatures
What is a formulation	Formulations are useful mixtures, made up in definite proportions, designed to give a product the best properties possible to carry out its function
How are formulations used in the pharmaceutical industry	Formulations are really important in the pharmaceutical industry. For example, by altering the formulation of a pill, chemists can make sure it delivers the drug to the correct part of the body at the right concentration, that it's consumable and has a long shelf life.
Describe the formulations of paints	A pigment is used to provide colour, a binder is used to help the paint attach itself to an object and to form a protective flim when dry and a solvent to help the pigment and binder spread well during painting by thinning them out
Describe the formulations of washing up liquids	A surfactant so that the detergent removes the grease, water to thin out the mixture so it can squirt more easily from the bottle, colouring and fragrance additives, to improve the appeal of the product to potential customers and rinse agent to help water drain off crockery
What is chomatography	Chromatography is an analytical method used to separate the substance in a mixture, which can than be used to identify the substances
How are substances separated in paper chromatography	Paper chromatography allows us to separate substances based on their different solublities
What is meant by the mobile phase of chromatography	The mobile phase in chromatography is the solvent which carries the dissolved substances
What is meant by the stationary phase of chromatography	The stationary phase in chromatography the fixed surface on which the process takes place
How far do molecules with a higher solubility travel up paper	Molecules with a higher solubility in the solvent, and which are less attracted to the paper, will spend more time in the moblie phase and they'll be carried further up the paper
How can you distinguish between a pure and impure substance using chromatography	Given an unknown organic solution, chromatography can usually tell you if it is a single compound or a mixture. If the unknown sample is a mixture of compounds, there will probably be more than one spot formed onthe chromatogram. On the other hand a single spot indicates the possiblity of a pure substance
Equation of Retention factor	Rf = distance moved by substance / distance moved by solvent
What is the Retention factor	An Rf value is the ratio between the distance travelled by the dissloved substance and the distance travelled by the solvent
How far do molecules with a lower solubility travel up paper	Molecules with a lower solubility in the solvent, and which are strongly attracted to the paper, will spend more time in the stationary phase and they'll not move very far
Why do we draw our starting line in pencil	If we drew the line in pen, the pen ink would move up the paper, with the solvent
How would you test for chlorine	Chlorine turns damp blue litmus paper redand then bleaches it, turing it white
How would you test for oxygen	If you put a glowing splint inside a test tube conatining oxygen, the oxygen will relight the glowing splint
How would you test for carbon dioxide	Bubbling carbon dioxide with an aqueous solution of calcium hydroxide, which is limewater, causes the solution to turn cloudy
How would you test for hydrogen	If you hold a lit splint at the open end of a test tube containing hydrogen, you'll hear a squeaky pop
What the flame test colour of a Lithium ion	Lithium ions burn with a crimson flame
What the flame test colour of a Sodium ion	Sodium ions burn with a yellow flame
What the flame test colour of a Potassium ion	Potassium ion burns with a liliac flame
What the flame test colour of a Calcium ion	Calcium ions burn with a orange-red flame
What the flame test colour of a Copper ion	Copper ions burn with a green flame
General word equation for carbonate reacting with an acid	Carbonate + Acid => Salt + Water + Carbon dioxide
Describe how a flame test should br carried out	-A nichrome wire loop should be dipped in concentrated hydrochloric acid and then heated to clean it first.  -Then it should be dipped in the acid again before dipping it into the metal compound that is being tested.  -Then hold the loop in the roaring blue flame to identify the metal ion in the compund
Why won't flame tests work with a mixture of metal ions	If the sample being tested contains a mixture of metal ions, then some flame colours can be masked.
How can you test for metal cations	Reacting unknown compounds with sodium hydroxide solution can help you identify some positive ions as many metal hydroxides are insoulbe and precipitate out of solution when formed
Which metal ion solutions turn white when you add sodium hydroxide	Aluminium ions, calcium ions and magnesium ions all form white percipitates when sodium hydroxide solution is added
How can you distinguish aluminium, calcium and magnesium solutions	If you add excess sodium hydroxide, then the precipitate formed with aluminium ions dissovles. However, the white precipitate formed with calcium or magnesium ions will not dissoljve. Flame tests can be used to distinguish between calcium or magnesium ions
Ionic Equation for Calcium precipitate	Ca2+(aq) + 2OH-(aq) => Ca(OH)2(s)
Ionic Equation for Iron precipitate	Fe3+(aq) + 3OH-(aq) => Fe(OH)3(s)
Ionic Equation for Aluminium precipitate	Al3+(aq) + 3OH-(aq) => Al(OH)3(s)
What colour precipitate does Copper form when reacted to sodium hydroxide	Copper forms a blue precipitate when reacted to sodium hydroxide
What colour precipitate does Iron(II) form when reacted to sodium hydroxide	Iron forms a green precipitate when reacted to sodium hydroxide
What colour precipitate does Iron(III) form when reacted to sodium hydroxide	Iron forms a brown precipitate when reacted to sodium hydroxide
How do you test for the carbonate ion	You can test if a solution contains carbonate ions by putting a sample in a test tube and reacting it with dilute acid. You should then connect the solution to a test tube of limewater. If carbonate ions are present, carbon dioxide will be released and that will turn the limewater milky
How would you test for halide ions	To identify a halide ion, add a few drop of nitric acid, and a few drops of silver nitrate solution
What colour precipitate would be produce by reacting iodine and Silver Nitrate	An iodine gives a yellow precipitate of the silver iodide
What colour precipitate would be produce by reacting chloride and Silver Nitrate	A chloride gives a white precipitate of the silver iodide
What colour precipitate would be produce by reacting bromide and Silver Nitrate	A bromide gives a cream precipitate of the silver iodide
General Ionic Equation of halide ion reacting with Silver Nitrate	Ag+(aq) + X-(aq) => AgX(s)
How would you test for sulfate ions	You can identify sulfate ions by adding dilute hydrochloric acid, followed by barium chloride solution. You add the dilute hydrochloric acid first to remove carbonate ions that would form a precipitate with barium ion. A white precipitate tells you sulfate ions are present
Ionic Equation of barium chloride reacting with sulfate ions	Ba2+ + SO42-(aq) => BaSO4(s)
How does Flame Emission Spectroscopy work	During flame emisson spectroscopy a sample is placed in a flame. As the ions heat up, their electrons become exicted. When the electrons drop back to their orginal energy levels, they can transfer energy as light. The light passes through a spectroscope, which can detect different wavelengths of light to produce a line spectrum
What does the wavelength in a spectroscopy depend on	The combination of wavelengths emmitted by an ion depends on its charge and its electron arrangement. Different ions emit different wavelengths of light. So each ion produces a different pattern of wavelengths and has a different line spectrum
What does the intensity of light indicate in spectroscopy	The intensity of the spectrum indicates the concentration of the ion in the solution. This means that line spectrums can be used to identify ions in solution and calculate their concentrations
Which substance can Flame emmission spectroscopy work on	Flame emmission spectroscopy can be used to identify different ions in mixtures. This makes them more useful than flame tests
What are the advantages to instrumental methods	- They are highly accurate and sensitive - They are very fast - They enable very small samples to be analysed
What are the disadvantages to instrumental methods	- They are very expensive - Takes special training to use - Gives results that can often be interpreted only by comparison with data from known substance
- They are highly accurate and sensitive - They are very fast - They enable very small samples to be analysed	What are the advantages to instrumental methods
- They are very expensive - Takes special training to use - Gives results that can often be interpreted only by comparison with data from known substance	What are the disadvantages to instrumental methods
What does the Retension factor depend on	The retension factor depends on the attraction of substance to paper and solvent
What are uses of Chromatography	Chromatography can be used to identify food colourings present in certin foods and in police investigations
What are the disadvantages of Chromatography	- Slow - Substance has to be solube  - Good for analysis, not for isolating a sample
Student wants to increase rate of reaction, and decides to try two techniques:   1. Increasing the volume of the reaction vessel 2. Increasing the temperture at which the reaction is carried out    Explain using collision theory, whether or not these changes will increase the rate of reaction	Increasing the volume of the reaction vessel would decrease the pressure of the gases. So the particles would be more spread out and would collide less frequently, so the rate of reaction would decrease. Increasing the temperature would cause the particles to move faster, so the frequncy of successful collisions and the rate of reaction will increase
How was the earth's early atomsphere formed	The earth's early atomsphere was formed by volcanic activity
Which gases formed the Earth's early atomsphere	The early atomsphere consisted of mostly carbon dioxide with little or no oxygen. There may have also been nitrogen and water vapour, together with traces of methane and ammonia
Which proportions of gases formed the modern atmosphere	Around 78% of the atmosphere is nitrogen and around 21% is oxygen. There are also small proportions of gases such as carbon dioxide, water vapour and noble gases such as argon
Why can't scientist be sure about the composition of the Earth's early atmosphere	The earth is around 4600 millions years old and that means that scientists cannot be certain about the early atomsphere
Suggest two possible sources of the water that collected to form the early oceans	The water vapour in the atmosphere condensed as the Earth gradually cooled down and fell as rain. Another theory speculates that comets could also have brought water to the Earth increasing the to its water supply
How did the amount of oxygen in the atmosphere increase	Bacteria and other simple organisms such as algae, evolved and could use the energy from the sun to make their own food by photosynthesis, producing oxygen gas as a waste product. As plants evolved, they successfully colonised most of the Earth's surfaces and so the atmosphere became richer with oxygen.
How did the amount of carbon dioxide in the atmosphere decrease	The carbon dioxide from the atmosphere dissolved in the oceans, where it reacted with minerals to form insoluble carbonates, such as calcium carbonate, that formed sediments on the seabed. It was also taken in by animals to become a part of skeletons and shells and swhen the animal dies, this becomes a sedimentary rock Some CO2 was used in photosynthesis to make oxygen.
Explain how the levels of oxygen on the earth increased and why this was important                                                                            [6 marks]	The first organisms photosynthesized, using carbon dioxide and water and made oxygen gas and glucose which was used for respiration. These simple organisms evolved into the first marine plants and then land plants, the increasing numbers of photosynthetic organisms further increased the levels of oxygen in atmosphere and eventually their was sufficient oxygen to support living organisms to evolve so that they did not rely on photosynthesis for energy. These organisms fed on algae and plants and could release energy stored in them by using oxygen gas in the process of respiration
Why did scientist believe that there was no life on Earth during the first billion years of the earth's existance	As there was no liquid water because temperature too hot for organisms to survive
How was the ammonia and methane removed form the atmopshere	Any ammonia and methane was removed by reactions with oxygen, once oxygen had been formed by photosythesis
explain the orgins of nitrogen and why its composition of the air is high	Nitrogen gas was produced by volcanoes in the early atmosphere, along with traces of ammonia gas, the ammonia reacted with oxygen to form more nitrogen gas and the levels of nitrogen gas remained high because it is very unreactive
How is coal formed	If ferns or trees die in marshy wetlands, they donâ€™t decompose due to a lack of oxygen or acidic conditions, over time the remains are covered in sediment and compressed, a high temperature and pressure create coal
How is Crude oil formed	Plankton die and settle in the sea bed and no there is no oxygen to decompose, overtime theyâ€™re compressed by sediment and heat and pressure convert them into crude oil
How is natural gas formed	Mainly the hydrocarbon methane, you can find them in deposits of oil because itâ€™s formed by plankton in a similar way to crude oil
Why has the amount of carbon dioxide in the atmosphere risen	The amount of carbon dioxide in the Earth's atmosphere has risen in the recent past, largely due to the amount of fossil fuels now burnt
What are the three greenhouse gases	Carbon dioxide, Methane and Water vapour
